ab = albite
alm = almandine
aperov = al_perovskite
an = anorthite
seif = seifertite
appv = al_post_perovskite
ca-pv = ca_perovskite
cts = ca_tschermaks
cen = clinoenstatite
cfs = not_in_dataset
cor = corundum
coe = coesite
di = diopside
en = enstatite
fc2/c = hp_clinoferrosilite
fa = fayalite
ffer = fe_ca_ferrite
faki = fe_akimotoite
fperov = fe_perovskite
fring = fe_ringwoodite
fwad = fe_wadsleyite
fo = forsterite
fppv = fe_post_perovskite
fs = ferrosilite
gr = grossular
herc = hercynite
hed = hedenbergite
jd = jadeite
jmaj = jd_majorite
ky = kyanite
c2/c = hp_clinoenstatite
mfer = mg_ca_ferrite
aki = mg_akimotoite
maj = mg_majorite
perov = mg_perovskite
ring = mg_ringwoodite
ts = mg_tschermaks
wad = mg_wadsleyite
ppv = mg_post_perovskite
nfer = na_ca_ferrite
neph = nepheline
odi = ortho_diopside
per = periclase
py = pyrope
q = quartz
sp = spinel
st = stishovite
wus = wuestite
